wwwwwwwwwwwwwww
w             w
w             w
w             w
w             w
w    www      w
w    w        w
w    w        w
w             w
w             w
wwwwwwwwwwwwwww